NO         ./textures/WALL03_1.png
SO     ./textures/W96_2.png
WE ./textures/WALL69_4.png
EA ./textures/RP1_1.png

F 95, 95, 95

C 35, 35, 35, 255

                                        1TTTTTTTTTTTTTTTTTT1
                                        10000000000000000001
                                        10000000000011110001
                                    111110000000000000001001
                                   1000D00000000000000001001
                                  100011100000000000000010011111
                                 10001   100000000000000100000011
                                10001    1000000000001111001110000OLL:LOL:OL
                               10001     1000000000000000001  10000000000001
                        P{||}{}P001      1TTTTTTTTTTTTTTTTT1   1100000000001
    1111   11111111111  1000000000:                              {|{{PP|}|}}
   100001  10000000001 1000T00T000K
  10000001110000000001110000000000L  
  10000000000000000000000000000000O
  1000000111000000000111000T00T000K
   100001  10000000001 10000000000:
    1111   11111111111  1000000000L
                        1111N111111
                           1D1