NO         ./textures/W28_6.png
SO     ./textures/W96_2.png
WE ./textures/WALL69_4.png
EA ./textures/RP1_1.png

F 95, 95, 95

C 35, 35, 35, 255

11111
10001
10N01
10001
11111