NO         ./textures/WALL69_4.png
SO     ./textures/WALL71_5.png
WE ./textures/W28_8.png
EA ./textures/W28_6.png

F 0,255,124,241

C 132,145,75,0

C 30  ,  00,10
F 80,60,30

        111111111111T1111111111T1
        1000000000000000000000001
        1011000000000001110000001
       1001T000000000001D100000011
      110111000000000001010000000D
     10000D000000000N0000000000011
      110111000000000000000000001
       100110000000T0000000000001
        1001000000000000000000001
111111111011000001110000000000001
100000000011000001110111110111111
11110111111111011100000011D1
11111111111111011101010011111
11000000110101011100000010001
10000000000000001100000010001
10000000000000001101010010001
110000011101010111110111100111
11110111 1110101 101111010001
11111111 1111111 11111111111111111
