NO         ./textures/LAVA3.png
SO     ./textures/LAVA3.png
WE ./textures/LAVA3.png
EA ./textures/LAVA3.png
EA ./textures/LAVA3.png

F 154, 105, 55, 255

C 85, 161, 239

1111111111111111111111111111111
1011111111110011101111111111111
1000000000110000001000000000001
1011000001110000001000000000001
1001000000010000001000000000001
1111111110110000001000011100001
10000000000E0000000000011101111
1111000000110000001101110000001
1111000000110000001101110101001
1100000011010000001101110000001
1000000000010000001000110000001
1000000000010000001000110101001
1111111111111111111111111111111
