NO         ./textures/LAVA3.png
SO     ./textures/LAVA3.png
WE ./textures/LAVA3.png
EA ./textures/LAVA3.png
EA ./textures/LAVA3.png
F 220,100,0
C 225,30,0
1111100000011110111100000000000
101111111111  111 1111111111111
100000000011      1000000000001
101100000111      1000000000001
100100000001      1000000000001
111111111011      1000011100001
1000000000000000000000011101111
111100000011      1101110000001
111100000011      1101110101001
110000N01101      1101110000001
100000000001      1000110000001
100000000001      1000110101001
111111111111      11
