NO         ./textures/WALL69_4.png
SO     ./textures/WALL71_5.png
WE ./textures/W28_8.png
EA ./textures/W28_6.png

F 0,255,124,241

C 132,145,75,0

C 30  ,  00,10
F 80,60,30

        111111111111T1111111111T1
        1000000000000000000000001
        1011000000000000000000001
        101T000000000000000000001
        1011000000000000000000001
        101100000000N000000000001
        1011000000000000000000001
        10110000000T0000000000001
        1001000000000000000000001
111111111011000001110000000000001
100000000011000001110111111111111
1111011111111101110000001
11111111111111011101010011111
11000000110101011100000010001
10000000000000001100000010001
10000000000000001101010010001
110000011101010111110111100111
11110111 1110101 101111010001
11111111 1111111 1111111111111111
