NO         ./texture/brick_256.xpm
SO     ./texture/rock_256.xpm
WE ./texture/brick_256.xpm

EA ./texture/rock_256.xpm

EA ./texture/rock_256.xpm



F 220,100,0
C 225,30,0

           1111 1111
111111111111  111 1111111111111
100000000011      1000000000001
101100000111      10000E0000001
100100000001      1000000000001
111111111011      1000011100001
1000000000000000000000011101111
111100000011      1101110000001
111100000011      1101110101001
110000001101      1101110000001
100000000001      1000110000001
100000000001      1000110101001
111111111111      1111111111111
           11111111
