NO ./textures/S1.png
SO ./textures/S2.png
WE ./textures/S3.png
EA ./textures/S4.png
F 65,103,64
C 39,37,35

     1111111111111111111111111111
111111111000000000110000000000001
 11111111011000001110000000000001
1111111110010000000000000N0000001
111111111011000001110000000000001
100000000011000001110111111111111
111101111111110111000000100011111
111101111111110111010100100011111
110000001101010111000000100011111
100000000000000011000000100011111
100000000000000011010100100011111
110000011101010111110111100011111
111101111111010111011110100011111
111111111111111111111111111111111