NO ./texture/brick_256.xpm
SO ./texture/rock_256.xpm
WE ./texture/brick_256.xpm
EA ./texture/rock_256.xpm
F 65,    103    ,    64
C 2,11,83

11111111
10000001
11000011
10000001
100N0011
11000001
10000001
11111111
