NO ./texture/brick_256.xpm
SO ./texture/rock_256.xpm
WE ./texture/brick_256.xpm
EA ./texture/rock_256.xpm
F 65,    103    ,    64
C 2,11,83
111111
100101
101001
1100N1
111111
