NO         ./textures/WALL03_1.png
SO     ./textures/W96_2.png
WE ./textures/WALL69_4.png
EA ./textures/RP1_1.png

F 95, 95, 95

C 35, 35, 35, 255

                            11111111111111
     111111                 10000000000001
     101111      111111111111000000000000111111
     1000011     100000000011000000000000110001
     1000001     1000000000D00000000000000D0001
     1000001     100000000011000000000000110001
     11111D11111 10001111111000000000000011111
     10000000001 10001      10000000000001
     1000000000111000111    1111111D111111
     1000000000110000001         11011
     1000000000D00000001         10001
     1000000000110000001         00000
111111000000000111111111         10001
1000110000000001                 10001
1000111111D11111            111111000111
10001   10001               110D00000001
11D11   10001               100111000111
1000111110001               1001 10001
1000100010001               1001 10001
1000000010001               1111 10001
1000100010001                    11D11
1000111111D11111                 11011                1111111111
1000110000000001           11111100000111111          1000000001
1000110000000001           10000000000000001          1000000001
1000110000000001           1000000000000000111111111111000000001
1000010000000001           1000000000000000010000000001000000001
10000D0000000001           10000000T00000000D000000000D000000001
1000010000000001           1000000000000000010000000001000000001
1000110000000001           1000000000000000111100001111000000001
1000110000000001           10000000000000001  110011  1000000001
1000110000000001           11111100000111111   1001   1000000001
1000111111D11111                111D111        1001   1110110111
10001   10001                    11011         1001     111111
1000111110001                    10001         1001
1000100010001                    10001         1001 111111111
1000000010001                    10001         100111010101011
1000100010001                    10001         100010000000001
1000111110001                    10001         1000D0000000001
1000111110001111111111111        10001         100010000000001
100000000000000001000000111      10001         111111010101011
10000000000000000D000000001      10001              111111111
100000000000000001000000111      10001
111111111101111111D111111        11D11
         11100100D001       111111101111111
         10D001001011       100001000100001
         11100000111        10000D000D00001
           11D1111          100001000100001
            T00TTTTTTT      100001000100001
        TTTTT00000000T      111111000111111
        T000000000000T      100011000100001
        T00TTTTTTTTTTT      1E000D000D00001
        P00O                100011000100001
        P00:                111111000111111
        {00L                100000000000001
        }00K                100000000000001
        |00L                100000000000001
        TTTT                1111111D1111111