NO         ./textures/WALL69_4.png
SO     ./textures/WALL71_5.png
WE ./textures/W28_8.png
EA ./textures/W28_6.png

F 0,255,124,241

C 132,145,75,0

C 30  ,  00,10
F 80,60,30

        1111111{P}1O}{P}|}P{P{}}T1
        1000000|}{000000000000000L
        1011000000000D00000000000L
       1001T00000000000000000000:1
      1101110000000000000D0000000D
     10000D000000000N00000000000:1
      11011100000000000000000000L
       100110000000T000000000000L
        100100000000000000000000K
11111111101100000111000000000000L
1000000000110000011101111101111:1
11110111111111011100000011D1
11111111111111011101010011111
11000000110101011100000000001
10000000000000001100000010001
10000000000000001101010010001
11000001110101011111011110000001
11110111 1110101 101111010001
11111111 1111111 111111111111
